24 24 22 4  
4 1 1 2 2 2 2 2 4 4 4 4 4 4 4 4 2 2 2 3 4 5 6 7
4 0 0 0 0 0 0 0 0 0 0 0 0 0 0 0 2 0 0 0 0 0 0 8
4 0 1 0 0 0 0 0 0 1 0 0 0 0 0 0 0 0 0 0 0 0 0 9
4 0 2 0 0 0 0 0 0 0 0 0 0 0 0 0 0 0 0 0 0 0 0 10
4 0 3 0 0 0 0 0 0 0 0 0 0 0 0 0 2 0 0 0 0 0 0 11
4 0 4 0 0 0 0 3 3 3 3 3 3 3 3 3 2 16 0 14 15 6 12 2
4 0 5 0 0 0 0 3 0 3 0 3 0 3 0 3 2 0 0 0 2 2 2 1
4 0 6 0 0 0 0 3 0 0 0 0 0 0 0 3 2 0 0 0 0 0 0 7
4 0 2 0 0 0 0 0 0 0 0 0 0 0 0 0 0 0 0 0 2 2 2 1
4 0 7 0 0 0 0 3 0 0 0 0 0 0 0 3 2 0 0 0 0 0 0 7
4 0 0 0 0 0 0 3 0 0 0 0 0 0 0 3 2 0 0 0 2 2 2 1
4 0 0 0 0 0 0 3 3 3 3 0 3 3 3 3 2 2 2 2 2 2 2 1
6 6 6 6 6 6 6 6 6 6 6 0 6 6 6 6 6 6 6 6 6 6 6 6
7 0 0 0 0 0 0 0 0 0 0 0 0 0 0 0 0 0 0 0 0 0 0 4
6 6 6 6 6 6 0 6 6 6 6 0 6 6 6 6 6 6 6 6 6 6 6 6
4 4 4 4 4 4 0 4 4 4 6 0 6 2 2 2 2 2 2 2 3 3 3 3
4 0 0 0 0 0 0 0 0 4 6 0 6 2 0 0 0 0 0 2 0 0 0 2
4 0 0 0 0 0 0 0 0 0 0 0 6 2 0 0 3 0 0 2 0 0 0 2
4 0 0 0 0 0 0 0 0 4 6 0 6 2 0 0 0 0 0 2 2 0 2 2
4 0 6 0 6 0 0 0 0 4 6 0 0 0 0 0 3 0 0 0 0 0 0 2
4 0 0 3 0 0 0 0 0 4 6 0 6 2 0 0 0 0 0 2 2 0 2 2
4 0 6 0 6 0 0 0 0 4 6 0 6 2 0 0 3 0 0 2 0 0 0 2
4 0 0 0 0 0 0 0 0 4 6 0 6 2 0 0 0 0 0 2 0 0 0 3
4 4 4 4 4 4 4 4 4 4 1 1 1 2 2 2 2 2 2 3 3 3 3 3