7 125 4 2
1 1 15 14 1 1 1
1 0 0 0 0 0 1
1 0 0 0 0 0 1
1 3 3 0 4 4 1
1 0 0 0 0 0 1
1 0 0 0 0 0 1
1 0 0 0 0 0 1
1 0 0 1 1 1 1
1 0 0 0 0 0 1
1 0 1 0 0 0 1
1 0 0 1 0 0 1
1 0 0 0 0 0 1
1 0 0 0 1 1 1
1 0 0 0 0 0 1
1 0 0 0 0 0 1
1 0 2 2 0 0 1
1 0 0 0 0 0 1
1 0 0 0 0 0 1
1 0 0 2 2 0 1
1 0 0 0 0 0 1
1 0 0 0 0 0 1
1 0 0 0 0 0 1
1 0 6 6 0 0 1
1 0 0 0 0 0 1
1 5 5 5 0 0 1
1 0 0 0 0 0 1
1 0 0 0 0 0 1
1 0 0 0 0 0 1
1 0 0 2 2 2 1
1 0 0 0 0 0 1
1 0 0 0 0 0 1
1 0 4 4 0 0 1
1 0 0 0 0 0 1
1 0 0 0 0 0 1
1 0 0 0 0 0 1
1 0 0 0 0 0 1
1 0 0 0 0 0 1
1 0 0 0 0 0 1
1 0 0 0 0 0 1
1 0 0 0 0 0 1
1 0 0 0 0 0 1
1 0 0 0 0 0 1
1 0 0 0 0 0 1
1 0 0 0 2 0 1
1 0 0 0 1 0 1
1 0 0 0 5 0 1
1 0 0 2 2 0 1
1 0 0 0 0 0 1
1 0 0 0 0 0 1
1 3 0 4 0 0 1
1 3 0 3 0 0 1
1 5 0 3 0 0 1
1 5 0 4 0 0 1
1 4 0 5 0 0 1
1 4 0 6 0 0 1
1 0 0 0 0 0 1
1 0 0 0 0 0 1
1 0 2 0 0 0 1
1 0 0 2 0 0 1
1 0 0 0 2 0 1
1 0 0 0 0 0 1
1 0 0 0 0 0 1
1 0 1 0 0 0 1
1 0 2 0 0 0 1
1 0 2 0 0 0 1
1 0 0 0 0 0 1
1 0 0 0 3 0 1
1 0 0 0 0 0 1
1 0 0 0 0 0 1
1 0 0 0 0 0 1
1 0 6 6 0 0 1
1 0 0 0 0 0 1
1 5 5 5 0 0 1
1 0 0 0 0 0 1
1 0 0 0 0 0 1
1 0 0 0 0 0 1
1 0 0 2 2 2 1
1 0 0 0 0 0 1
1 0 0 0 0 0 1
1 0 4 4 0 0 1
1 0 0 0 0 0 1
1 0 0 0 0 0 1
1 0 0 0 0 0 1
1 0 0 0 0 0 1
1 0 0 0 0 0 1
1 0 0 0 0 0 1
1 0 0 0 0 0 1
1 0 0 0 0 0 1
1 0 0 0 0 0 1
1 0 0 0 0 0 1
1 0 0 0 0 0 1
1 0 2 0 0 0 1
1 0 0 2 0 0 1
1 0 0 0 2 0 1
1 0 0 0 0 0 1
1 0 0 0 0 0 1
1 0 0 0 0 0 1
1 3 0 4 0 0 1
1 3 0 3 0 0 1
1 5 0 3 0 0 1
1 5 0 4 0 0 1
1 4 0 5 0 0 1
1 4 0 6 0 0 1
1 0 0 0 0 0 1
1 0 0 0 0 0 1
1 0 2 0 0 0 1
1 0 0 2 0 0 1
1 0 0 0 2 0 1
1 0 0 0 0 0 1
1 0 0 0 0 0 1
1 0 1 0 0 0 1
1 0 2 0 0 0 1
1 0 2 0 0 0 1
1 0 0 0 0 0 1
1 0 0 0 3 0 1
1 0 0 0 0 0 1
1 1 1 0 0 0 1
1 2 2 3 0 1 1
1 0 0 0 0 0 1
1 0 0 0 0 0 1
1 0 6 0 0 0 1
1 0 0 6 0 0 1
1 0 0 0 6 0 1
1 0 0 0 0 0 1
1 1 14 15 1 1 1